 4  9  9  9  9 9 9 9 9 5 9 9 9 9 9 9 9 9 6
17 30 30 30 30 30 30 30 30 17 30 30 30 30 30 30 30 30 17
17 30 4 6 30 4 9 6 30 17 30 4 9 6 30 4 6 30 17
17 29 24 26 30 24 9 26 30 27 30 24 9 26 30 24 26 29 17
17 30 30 30 30 30 30 30 30 30 30 30 30 30 30 30 30 30 17
17 30 8 10 30 7 30 8 9 5 9 10 30 7 30 8 10 30 17
17 30 30 30 30 17 30 30 30 17 30 30 30 17 30 30 30 30 17
24  9  9  6 30 14  9 10  0 27  0 8 9 16 30 4 9 9 26
88 88 88 17 30 17 -1 -1 -1 -1 -1 -1 0 17 30 17 88 88 88
 9  9  9 26 30 -1 -1  4  9  0  9 -1 -1 27 30 24 9 9 9
98  0  0  0 30 -1  0 17 49 48 47 17 -1 0 30 0 0 0 99
 9  9  9  6 30 -1  0 24  9  9  9 26 -1  7 30  4  9  9  9
88 88 88 17 30 -1  0  0  0 45  0  0 -1 -1 30 17 88 88 88
 4  9  9 26 30 -1  0  8  9  5  9 10 -1 27 30 24 9 9 6
17 30 30 30 30 -1 -1 30 30 17 30 -1 -1 30 30 30 30 30 17
17 29  8  6 30  8 -1 -1 -1 -1 -1 -1 9 10 30 4 10 29 17
17 30 30 17 30 30 30 30 30 30 30 30 30 30 30 17 30 30 17
14 10 30 27 30 7 30 8 9 5 9 10 30 7 30 27 30 8 16
17 30 30 30 30 17 30 30 30 17 30 30 30 17 30 30 30 30 17
17 30 8 9 9 25 9 10 30 27 30 8 9 25 9 9 10 30 17
17 30 30 30 30 30 30 30 30 30 30 30 30 30 30 30 30 30 17
24 9 9 9 9 9 9 9 9 9 9 9 9 9 9 9 9 9 26
